151,199,152,-1,-1,-1,-1,694,696,-1,-1,-1,-1,-1,-1,-1,-1,-1,-1,-1,-1,-1,196,197,198,199,200,-1,-1,-1,-1,-1,-1,-1,-1,-1,436,437,438,-1,-1,-1,-1,-1,-1,-1,-1,-1,-1,-1,-1,-1,-1,-1,-1,-1,-1,-1,-1,-1,-1,-1,-1,-1,-1,-1,-1,-1,-1,-1,-1,-1,-1,-1,-1,-1,-1,-1,-1,-1,-1,-1,-1,-1,-1,-1,-1,-1,-1,196,149,150,150,150,150,150,151,152,293,294,295,296,695,695,-1,-1,-1,-1,-1,-1,-1,-1,-1,-1,-1,100,101,102,103,104,-1,-1,-1,-1,-1,-1,-1,-1,-1,-1,-1,-1,-1,-1,-1,-1,-1,-1,-1,-1,-1,-1,-1,-1,-1,-1,-1,-1,-1,-1
199,247,248,-1,-1,-1,-1,694,696,-1,-1,-1,-1,-1,-1,388,389,390,-1,-1,-1,-1,196,197,198,199,200,-1,-1,-1,-1,-1,-1,-1,-1,-1,484,485,486,647,647,647,647,647,647,647,647,647,648,-1,-1,-1,-1,-1,-1,-1,-1,-1,-1,-1,-1,-1,-1,-1,-1,-1,-1,-1,-1,-1,-1,-1,-1,-1,-1,-1,-1,-1,-1,-1,-1,-1,-1,-1,-1,-1,-1,-1,-1,196,197,198,198,198,198,198,198,200,695,695,695,695,695,695,-1,-1,-1,-1,-1,-1,-1,-1,-1,-1,-1,148,149,150,151,152,-1,-1,-1,-1,-1,-1,-1,-1,-1,-1,-1,-1,-1,-1,-1,-1,-1,-1,-1,-1,-1,-1,-1,-1,-1,-1,-1,-1,-1,-1
247,151,152,646,647,647,647,695,696,-1,-1,-1,-1,-1,-1,436,437,438,-1,-1,-1,-1,196,197,198,199,200,-1,646,647,648,-1,-1,-1,-1,-1,-1,-1,694,695,695,695,695,695,452,453,456,457,457,458,-1,-1,100,101,101,102,103,101,102,103,101,102,103,101,102,103,103,104,-1,-1,-1,-1,-1,-1,-1,-1,-1,-1,-1,-1,-1,-1,-1,-1,-1,-1,-1,-1,-1,196,197,198,198,198,198,198,198,248,695,695,695,695,695,695,-1,-1,-1,-1,-1,-1,-1,-1,-1,-1,-1,196,197,198,199,200,-1,-1,-1,-1,-1,-1,-1,-1,-1,-1,-1,-1,-1,-1,-1,-1,-1,-1,-1,-1,-1,-1,-1,-1,-1,-1,-1,-1,-1,-1
151,199,200,695,695,695,695,695,696,-1,-1,-1,-1,-1,-1,484,485,486,-1,-1,-1,-1,196,197,198,199,200,-1,694,695,696,-1,-1,-1,-1,-1,-1,-1,694,695,695,695,695,695,695,695,695,695,696,-1,-1,-1,148,149,150,150,150,150,150,150,150,150,150,150,150,150,150,152,-1,-1,-1,-1,-1,-1,646,647,647,647,647,647,647,647,647,647,647,647,647,647,648,196,197,198,198,198,198,198,198,198,101,102,103,200,-1,-1,-1,-1,-1,-1,-1,-1,-1,-1,-1,-1,-1,196,197,198,199,200,-1,-1,-1,-1,-1,-1,-1,-1,-1,-1,-1,-1,-1,-1,-1,-1,-1,-1,-1,-1,-1,-1,-1,-1,-1,-1,-1,-1,-1,-1
199,247,248,742,100,101,103,104,696,-1,-1,-1,-1,-1,-1,-1,-1,-1,-1,-1,-1,-1,196,197,198,199,200,647,648,743,744,100,101,102,103,104,-1,-1,694,695,695,695,695,695,695,695,695,695,696,-1,-1,-1,196,197,198,198,198,198,198,198,198,198,198,198,198,198,199,200,-1,-1,-1,-1,-1,-1,694,695,695,695,695,695,695,695,695,695,695,695,695,695,696,196,197,198,198,198,198,198,198,198,198,198,151,200,-1,-1,-1,-1,-1,-1,-1,-1,-1,-1,-1,-1,-1,196,197,198,199,200,-1,-1,-1,-1,-1,-1,-1,-1,-1,-1,-1,-1,-1,-1,-1,-1,-1,-1,-1,-1,-1,-1,-1,-1,-1,-1,-1,-1,-1,-1
247,151,152,-1,148,149,151,152,696,-1,-1,-1,-1,-1,-1,-1,-1,-1,-1,-1,-1,-1,196,197,198,199,200,695,696,-1,-1,148,149,150,151,152,-1,-1,694,452,458,695,695,695,695,695,695,695,696,-1,-1,-1,196,197,198,198,198,198,198,198,198,198,198,198,198,198,199,248,-1,-1,-1,-1,-1,-1,694,695,695,695,695,695,695,695,695,695,695,695,695,695,696,196,197,198,198,198,198,198,198,198,198,198,199,200,-1,-1,-1,100,101,102,102,102,102,103,104,-1,-1,244,245,246,247,248,-1,-1,-1,-1,-1,-1,-1,-1,-1,-1,-1,-1,-1,-1,-1,-1,-1,-1,-1,-1,-1,-1,-1,-1,-1,-1,-1,-1,-1,-1
151,199,200,-1,292,293,295,296,696,-1,-1,-1,-1,-1,-1,-1,-1,-1,-1,-1,-1,-1,196,197,198,199,200,743,744,-1,-1,292,293,294,295,296,-1,-1,694,695,695,695,695,695,695,695,695,695,696,-1,-1,-1,196,197,198,198,198,198,198,198,198,198,198,198,198,198,199,152,-1,-1,-1,-1,-1,-1,694,695,695,695,695,695,695,695,695,695,695,695,695,695,696,196,197,198,198,198,198,198,198,198,198,198,199,200,-1,-1,-1,196,149,150,150,150,150,151,152,-1,-1,292,293,294,295,296,-1,-1,-1,-1,-1,-1,-1,-1,-1,-1,-1,-1,-1,-1,-1,-1,-1,-1,-1,-1,-1,-1,-1,-1,-1,-1,-1,-1,-1,-1
199,247,248,-1,-1,-1,694,695,696,-1,452,458,-1,-1,-1,-1,-1,-1,-1,-1,-1,646,244,245,246,247,248,457,458,-1,-1,-1,-1,-1,-1,-1,-1,-1,694,695,695,695,695,695,695,695,695,695,696,-1,-1,-1,196,197,198,198,198,198,198,198,198,198,198,198,198,198,199,200,-1,-1,-1,-1,-1,-1,694,695,695,695,695,695,695,695,695,695,695,695,695,695,696,196,197,198,198,198,198,198,198,198,198,198,199,200,-1,-1,-1,196,197,198,198,198,198,199,200,-1,-1,-1,-1,-1,-1,-1,-1,-1,-1,-1,-1,-1,-1,-1,-1,-1,-1,-1,-1,-1,-1,-1,-1,-1,-1,-1,-1,-1,-1,-1,-1,-1,-1,-1,-1,-1
247,151,152,-1,-1,-1,742,743,744,-1,-1,-1,-1,-1,-1,412,412,-1,-1,-1,-1,694,292,293,294,295,296,-1,-1,-1,-1,-1,-1,-1,-1,-1,-1,-1,694,695,695,695,695,695,695,695,695,695,696,-1,-1,-1,196,197,198,198,198,198,198,198,198,198,198,198,198,198,199,248,101,101,101,101,104,-1,694,695,695,695,695,695,695,695,695,695,695,100,101,102,102,196,197,198,198,198,198,198,198,198,198,198,199,200,-1,-1,-1,196,197,198,198,198,198,199,200,-1,-1,-1,-1,-1,-1,-1,-1,-1,-1,-1,-1,-1,-1,-1,-1,-1,-1,-1,-1,-1,-1,-1,-1,-1,-1,-1,-1,-1,-1,-1,-1,-1,-1,-1,-1,-1
151,199,200,-1,-1,-1,-1,-1,-1,-1,-1,-1,-1,-1,-1,452,458,-1,-1,-1,-1,742,695,695,695,695,696,-1,-1,-1,-1,-1,-1,-1,-1,-1,-1,-1,694,695,695,695,695,695,695,695,695,695,696,-1,-1,-1,196,197,198,198,198,198,198,198,198,198,198,198,198,198,247,248,647,648,-1,-1,-1,-1,694,695,695,695,695,695,695,695,695,695,695,148,246,246,246,246,246,246,246,246,246,246,246,246,246,246,247,248,-1,-1,-1,196,197,198,198,198,198,199,200,-1,-1,-1,-1,-1,-1,-1,-1,-1,-1,-1,-1,-1,-1,-1,-1,-1,-1,-1,-1,-1,-1,-1,-1,-1,-1,-1,-1,-1,-1,-1,-1,-1,-1,-1,-1,-1
199,247,248,-1,-1,-1,-1,-1,-1,-1,-1,-1,-1,-1,-1,-1,-1,-1,-1,-1,-1,452,453,454,455,456,457,458,-1,-1,452,458,-1,-1,-1,-1,-1,-1,694,695,695,695,695,-1,-1,-1,695,695,696,-1,-1,-1,196,197,198,198,198,198,-1,694,695,695,695,695,695,695,695,695,695,696,-1,-1,-1,-1,694,695,695,695,695,695,695,695,695,695,695,292,293,294,295,294,294,294,294,294,294,294,294,294,294,294,295,296,-1,-1,-1,196,197,198,198,198,198,199,200,-1,-1,-1,-1,-1,-1,-1,-1,-1,-1,-1,-1,-1,-1,-1,-1,-1,-1,-1,-1,-1,-1,-1,-1,-1,-1,-1,-1,-1,-1,-1,-1,-1,-1,-1,-1,-1
247,151,152,-1,-1,-1,-1,-1,-1,-1,-1,-1,-1,-1,-1,-1,-1,-1,-1,-1,-1,-1,-1,-1,-1,-1,-1,-1,-1,-1,-1,-1,-1,-1,-1,-1,-1,-1,694,695,695,695,695,-1,-1,-1,695,695,696,-1,-1,-1,196,197,198,198,198,198,-1,694,695,695,695,695,695,695,695,743,744,-1,-1,-1,-1,-1,694,695,695,695,695,695,695,695,695,695,695,695,695,695,696,-1,-1,-1,694,695,695,695,695,695,695,695,695,-1,-1,-1,-1,244,197,198,198,198,198,199,200,-1,-1,-1,-1,-1,-1,-1,-1,-1,-1,-1,-1,-1,-1,-1,-1,-1,-1,-1,-1,-1,-1,-1,-1,-1,-1,-1,-1,-1,-1,-1,-1,-1,-1,-1,-1,-1
151,199,200,-1,-1,-1,-1,-1,-1,-1,-1,-1,-1,-1,-1,-1,-1,-1,-1,-1,-1,-1,-1,-1,-1,-1,-1,-1,-1,-1,-1,-1,-1,-1,-1,-1,-1,-1,694,695,695,695,695,-1,-1,-1,695,695,744,-1,-1,-1,196,197,198,198,198,198,-1,694,695,695,695,695,695,695,695,-1,-1,-1,-1,-1,-1,-1,694,695,695,695,695,695,695,695,695,695,695,695,695,695,696,-1,-1,-1,-1,695,695,695,695,695,695,695,695,-1,-1,-1,-1,244,245,246,246,246,246,247,248,-1,-1,-1,-1,-1,-1,-1,-1,-1,-1,-1,-1,-1,-1,-1,-1,-1,-1,-1,-1,-1,-1,-1,-1,-1,-1,-1,-1,-1,-1,-1,-1,-1,-1,-1,-1,-1
199,247,248,673,674,675,676,677,678,679,680,681,682,673,674,675,676,677,678,679,680,681,682,673,674,675,676,677,-1,-1,680,681,682,673,674,675,676,677,678,679,680,681,682,673,674,675,676,677,678,679,680,681,244,245,246,246,246,246,673,674,675,676,677,678,679,680,681,677,678,679,680,681,682,673,674,675,676,677,678,679,680,681,682,673,674,675,676,677,678,679,680,681,673,674,675,676,677,678,679,680,681,682,673,674,675,292,293,294,294,294,294,295,296,674,675,676,677,678,679,680,681,682,673,674,675,676,677,678,679,680,681,682,673,674,675,676,677,678,679,680,681,682,673,674,675,676,677,678,679,680
247,724,725,721,722,723,724,725,726,727,728,729,730,721,722,723,724,725,726,727,728,729,730,721,722,723,724,725,-1,-1,728,729,730,721,722,723,724,725,726,727,728,729,730,721,722,723,724,725,726,727,728,729,730,721,722,723,724,725,726,727,728,729,730,721,722,723,724,725,726,727,728,729,730,721,722,723,724,725,726,727,728,729,730,721,722,723,724,725,726,727,728,729,721,722,723,724,725,726,727,728,729,730,721,722,723,724,725,726,727,728,729,730,721,722,723,724,725,726,727,728,729,730,721,722,723,724,725,726,727,728,729,730,721,722,723,724,725,726,727,728,729,730,721,722,723,724,725,726,727,728
